11111 
100001
100001
100001
 11111
