1111111111111111
10C11001100000C1
1011000110111111
10100C0000000001
1000011111100P01
11110011C0011111
1E11100111011111
10000000C1000011
1111001111111011
1111000000000011
1111111111111111
