11111111111111
10C110000000C1
10110001101111
10100C00000001
10000111100P01
1E111001110111
100000C1000011
11111111111111
