1111111111
100C1100P1
1011100001
1000000001
10C0011111
1110000001
1E01111101
1000000001
1111111111
