1111111111
10C11100C1
1011000001
10100C0001
1000000P01
1111100111
1E11100111
10000000C1
1111111111
