1111111111
10C11100C1
1010000001
10100C0001
1000000P01
1111100111
1E11100111
1000000001
1111111111
