1111111111111111111111111111111111111111
1000000000000000000000000000000000000001
111100C111111111111111111111111100000001
1000011100000000000000000000000100000001
100001C000000000000000000000000100000001
100001C000000000000000000000000100000001
100001C000000000000000000000000100000001
1000010000000000000000000000000100000001
1000011111111111111111111110000100000001
1000000000000000000000000000000100000001
100000C000000000000000000000000100000001
1111111110000000000000000000000100000001
100000C010000000000000000000000100000001
1001111110000000000000000000000100000001
100000C010000000000000000000000100000001
1000000000000000000000000000000100000001
1011111100000000000000000000000100000001
100000C100000000000000000000000100000001
1000000100000000000000000000E001000P0001
1000000000000000000000000000000100000001
1111111111111111111111111111111111111111
1111111111111111111111111111111111111111
1111111111111111111111111111111111111111
1111111111111111111111111111111111111111
1111111111111111111111111111111111111111
1111111111111111111111111111111111111111
1111111111111111111111111111111111111111
1111111111111111111111111111111111111111
1111111111111111111111111111111111111111
1111111111111111111111111111111111111111
1111111111111111111111111111111111111111
1111111111111111111111111111111111111111
1111111111111111111111111111111111111111
1111111111111111111111111111111111111111
1111111111111111111111111111111111111111
1111111111111111111111111111111111111111
1111111111111111111111111111111111111111
1000000000000000000000000000000000000001
111100C111111111111111111111111100000001
1000011100000000000000000000000100000001
100001C000000000000000000000000100000001
100001C000000000000000000000000100000001
100001C000000000000000000000000100000001
1000010000000000000000000000000100000001
1000011111111111111111111110000100000001
1000000000000000000000000000000100000001
100000C000000000000000000000000100000001
1111111110000000000000000000000100000001
100000C010000000000000000000000100000001
1001111110000000000000000000000100000001
100000C010000000000000000000000100000001
1000000000000000000000000000000100000001
1011111100000000000000000000000100000001
100000C100000000000000000000000100000001
1000000100000000000000000000E001000P0001
1000000000000000000000000000000100000001
1111111111111111111111111111111111111111
1000000000000000000000000000000000000001
111100C111111111111111111111111100000001
1000011100000000000000000000000100000001
100001C000000000000000000000000100000001
100001C000000000000000000000000100000001
100001C000000000000000000000000100000001
1000010000000000000000000000000100000001
1000011111111111111111111110000100000001
1000000000000000000000000000000100000001
100000C000000000000000000000000100000001
1111111110000000000000000000000100000001
100000C010000000000000000000000100000001
1001111110000000000000000000000100000001
100000C010000000000000000000000100000001
1000000000000000000000000000000100000001
1011111100000000000000000000000100000001
100000C100000000000000000000000100000001
1000000100000000000000000000E001000P0001
1000000000000000000000000000000100000001
1111111111111111111111111111111111111111
1000000000000000000000000000000000000001
111100C111111111111111111111111100000001
1000011100000000000000000000000100000001
100001C000000000000000000000000100000001
100001C000000000000000000000000100000001
100001C000000000000000000000000100000001
1000010000000000000000000000000100000001
1000011111111111111111111110000100000001
1000000000000000000000000000000100000001
100000C000000000000000000000000100000001
1111111110000000000000000000000100000001
100000C010000000000000000000000100000001
1001111110000000000000000000000100000001
100000C010000000000000000000000100000001
1000000000000000000000000000000100000001
1011111100000000000000000000000100000001
100000C100000000000000000000000100000001
1000000100000000000000000000E001000P0001
1000000000000000000000000000000100000001
1111111111111111111111111111111111111111
1000000000000000000000000000000000000001
111100C111111111111111111111111100000001
1000011100000000000000000000000100000001
100001C000000000000000000000000100000001
100001C000000000000000000000000100000001
100001C000000000000000000000000100000001
1000010000000000000000000000000100000001
1000011111111111111111111110000100000001
1000000000000000000000000000000100000001
100000C000000000000000000000000100000001
1111111110000000000000000000000100000001
100000C010000000000000000000000100000001
1001111110000000000000000000000100000001
100000C010000000000000000000000100000001
1000000000000000000000000000000100000001
1011111100000000000000000000000100000001
100000C100000000000000000000000100000001
1000000100000000000000000000E001000P0001
1000000000000000000000000000000100000001
1111111111111111111111111111111111111111
1000000000000000000000000000000000000001
111100C111111111111111111111111100000001
1000011100000000000000000000000100000001
100001C000000000000000000000000100000001
100001C000000000000000000000000100000001
100001C000000000000000000000000100000001
1000010000000000000000000000000100000001
1000011111111111111111111110000100000001
1000000000000000000000000000000100000001
100000C000000000000000000000000100000001
1111111110000000000000000000000100000001
100000C010000000000000000000000100000001
1111111111111111111111111111111111111111
1111111111111111111111111111111111111111
1111111111111111111111111111111111111111
1111111111111111111111111111111111111111
1000000000000000000000000000000000000001
111100C111111111111111111111111100000001
1000011100000000000000000000000100000001
100001C000000000000000000000000100000001
100001C000000000000000000000000100000001
100001C000000000000000000000000100000001
1000010000000000000000000000000100000001
1000011111111111111111111110000100000001
1000000000000000000000000000000100000001
100000C000000000000000000000000100000001
1111111110000000000000000000000100000001
100000C010000000000000000000000100000001
1001111110000000000000000000000100000001
100000C010000000000000000000000100000001
1000000000000000000000000000000100000001
1011111100000000000000000000000100000001
100000C100000000000000000000000100000001
1000000100000000000000000000E001000P0001
1000000000000000000000000000000100000001
1111111111111111111111111111111111111111
1000000000000000000000000000000000000001
111100C111111111111111111111111100000001
1000011100000000000000000000000100000001
100001C000000000000000000000000100000001
100001C000000000000000000000000100000001
100001C000000000000000000000000100000001
1000010000000000000000000000000100000001
1000011111111111111111111110000100000001
1000000000000000000000000000000100000001
100000C000000000000000000000000100000001
1111111110000000000000000000000100000001
100000C010000000000000000000000100000001
1001111110000000000000000000000100000001
100000C010000000000000000000000100000001
1000000000000000000000000000000100000001
1011111100000000000000000000000100000001
100000C100000000000000000000000100000001
1000000100000000000000000000E001000P0001
1000000000000000000000000000000100000001
1111111111111111111111111111111111111111
1000000000000000000000000000000000000001
111100C111111111111111111111111100000001
1000011100000000000000000000000100000001
100001C000000000000000000000000100000001
100001C000000000000000000000000100000001
100001C000000000000000000000000100000001
1000010000000000000000000000000100000001
1000011111111111111111111110000100000001
1000000000000000000000000000000100000001
100000C000000000000000000000000100000001
1111111110000000000000000000000100000001
100000C010000000000000000000000100000001
1001111110000000000000000000000100000001
100000C010000000000000000000000100000001
1000000000000000000000000000000100000001
1011111100000000000000000000000100000001
100000C100000000000000000000000100000001
1000000100000000000000000000E001000P0001
1000000000000000000000000000000100000001
1111111111111111111111111111111111111111
1000000000000000000000000000000000000001
111100C111111111111111111111111100000001
1000011100000000000000000000000100000001
100001C000000000000000000000000100000001
100001C000000000000000000000000100000001
100001C000000000000000000000000100000001
1000010000000000000000000000000100000001
1000011111111111111111111110000100000001
1000000000000000000000000000000100000001
100000C000000000000000000000000100000001
1111111110000000000000000000000100000001
100000C010000000000000000000000100000001
1001111110000000000000000000000100000001
100000C010000000000000000000000100000001
1000000000000000000000000000000100000001
1011111100000000000000000000000100000001
100000C100000000000000000000000100000001
1000000100000000000000000000E001000P0001
1000000000000000000000000000000100000001
1111111111111111111111111111111111111111
1001111110000000000000000000000100000001
100000C010000000000000000000000100000001
1000000000000000000000000000000100000001
1011111100000000000000000000000100000001
100000C100000000000000000000000100000001
1000000100000000000000000000E001000P0001
1000000000000000000000000000000100000001
1111111111111111111111111111111111111111
1000000000000000000000000000000000000001
111100C111111111111111111111111100000001
1000011100000000000000000000000100000001
100001C000000000000000000000000100000001
100001C000000000000000000000000100000001
100001C000000000000000000000000100000001
1000010000000000000000000000000100000001
1000011111111111111111111110000100000001
1000000000000000000000000000000100000001
100000C000000000000000000000000100000001
1111111110000000000000000000000100000001
100000C010000000000000000000000100000001
1001111110000000000000000000000100000001
100000C010000000000000000000000100000001
1000000000000000000000000000000100000001
1011111100000000000000000000000100000001
100000C100000000000000000000000100000001
1000000100000000000000000000E001000P0001
1000000000000000000000000000000100000001
1111111111111111111111111111111111111111
1000000000000000000000000000000000000001
111100C111111111111111111111111100000001
1000011100000000000000000000000100000001
100001C000000000000000000000000100000001
100001C000000000000000000000000100000001
100001C000000000000000000000000100000001
1000010000000000000000000000000100000001
1000011111111111111111111110000100000001
1000000000000000000000000000000100000001
100000C000000000000000000000000100000001
1111111110000000000000000000000100000001
100000C010000000000000000000000100000001
1001111110000000000000000000000100000001
100000C010000000000000000000000100000001
1000000000000000000000000000000100000001
1011111100000000000000000000000100000001
100000C100000000000000000000000100000001
1000000100000000000000000000E001000P0001
1000000000000000000000000000000100000001
1111111111111111111111111111111111111111
1000000000000000000000000000000000000001
111100C111111111111111111111111100000001
1000011100000000000000000000000100000001
100001C000000000000000000000000100000001
100001C000000000000000000000000100000001
100001C000000000000000000000000100000001
1000010000000000000000000000000100000001
1000011111111111111111111110000100000001
1000000000000000000000000000000100000001
100000C000000000000000000000000100000001
1111111110000000000000000000000100000001
100000C010000000000000000000000100000001
1001111110000000000000000000000100000001
100000C010000000000000000000000100000001
1000000000000000000000000000000100000001
1011111100000000000000000000000100000001
100000C100000000000000000000000100000001
1000000100000000000000000000E001000P0001
1000000000000000000000000000000100000001
1111111111111111111111111111111111111111
1000000000000000000000000000000000000001
111100C111111111111111111111111100000001
1000011100000000000000000000000100000001
100001C000000000000000000000000100000001
100001C000000000000000000000000100000001
100001C000000000000000000000000100000001
1000010000000000000000000000000100000001
1000011111111111111111111110000100000001
1000000000000000000000000000000100000001
100000C000000000000000000000000100000001
1111111110000000000000000000000100000001
100000C010000000000000000000000100000001
1001111110000000000000000000000100000001
100000C010000000000000000000000100000001
1000000000000000000000000000000100000001
1011111100000000000000000000000100000001
100000C100000000000000000000000100000001
1000000100000000000000000000E001000P0001
1000000000000000000000000000000100000001
1111111111111111111111111111111111111111
1000000000000000000000000000000000000001
111100C111111111111111111111111100000001
1000011100000000000000000000000100000001
100001C000000000000000000000000100000001
100001C000000000000000000000000100000001
100001C000000000000000000000000100000001
1000010000000000000000000000000100000001
1000011111111111111111111110000100000001
1000000000000000000000000000000100000001
100000C000000000000000000000000100000001
1111111110000000000000000000000100000001
100000C010000000000000000000000100000001
1001111110000000000000000000000100000001
100000C010000000000000000000000100000001
1000000000000000000000000000000100000001
1011111100000000000000000000000100000001
100000C100000000000000000000000100000001
1000000100000000000000000000E001000P0001
1000000000000000000000000000000100000001
1111111111111111111111111111111111111111
1000000000000000000000000000000000000001
111100C111111111111111111111111100000001
1000011100000000000000000000000100000001
100001C000000000000000000000000100000001
100001C000000000000000000000000100000001
100001C000000000000000000000000100000001
1000010000000000000000000000000100000001
1000011111111111111111111110000100000001
1000000000000000000000000000000100000001
100000C000000000000000000000000100000001
1111111110000000000000000000000100000001
100000C010000000000000000000000100000001
1001111110000000000000000000000100000001
100000C010000000000000000000000100000001
1000000000000000000000000000000100000001
1011111100000000000000000000000100000001
100000C100000000000000000000000100000001
1000000100000000000000000000E001000P0001
1000000000000000000000000000000100000001
1111111111111111111111111111111111111111
1000000000000000000000000000000000000001
111100C111111111111111111111111100000001
1000011100000000000000000000000100000001
100001C000000000000000000000000100000001
100001C000000000000000000000000100000001
100001C000000000000000000000000100000001
1000010000000000000000000000000100000001
1000011111111111111111111110000100000001
1000000000000000000000000000000100000001
100000C000000000000000000000000100000001
1111111110000000000000000000000100000001
100000C010000000000000000000000100000001
1001111110000000000000000000000100000001
100000C010000000000000000000000100000001
1000000000000000000000000000000100000001
1011111100000000000000000000000100000001
100000C100000000000000000000000100000001
1000000100000000000000000000E001000P0001
1000000000000000000000000000000100000001
1111111111111111111111111111111111111111
1000000000000000000000000000000000000001
111100C111111111111111111111111100000001
1000011100000000000000000000000100000001
100001C000000000000000000000000100000001
100001C000000000000000000000000100000001
100001C000000000000000000000000100000001
1000010000000000000000000000000100000001
1000011111111111111111111110000100000001
1000000000000000000000000000000100000001
100000C000000000000000000000000100000001
1111111110000000000000000000000100000001
100000C010000000000000000000000100000001
1001111110000000000000000000000100000001
100000C010000000000000000000000100000001
1000000000000000000000000000000100000001
1011111100000000000000000000000100000001
100000C100000000000000000000000100000001
1000000100000000000000000000E001000P0001
1000000000000000000000000000000100000001
1111111111111111111111111111111111111111
1000000000000000000000000000000000000001
111100C111111111111111111111111100000001
1000011100000000000000000000000100000001
100001C000000000000000000000000100000001
100001C000000000000000000000000100000001
100001C000000000000000000000000100000001
1000010000000000000000000000000100000001
1000011111111111111111111110000100000001
1000000000000000000000000000000100000001
100000C000000000000000000000000100000001
1111111110000000000000000000000100000001
100000C010000000000000000000000100000001
1001111110000000000000000000000100000001
100000C010000000000000000000000100000001
1000000000000000000000000000000100000001
1011111100000000000000000000000100000001
100000C100000000000000000000000100000001
1000000100000000000000000000E001000P0001
1000000000000000000000000000000100000001
1111111111111111111111111111111111111111
1000000000000000000000000000000000000001
111100C111111111111111111111111100000001
1000011100000000000000000000000100000001
100001C000000000000000000000000100000001
100001C000000000000000000000000100000001
100001C000000000000000000000000100000001
1000010000000000000000000000000100000001
1000011111111111111111111110000100000001
1000000000000000000000000000000100000001
100000C000000000000000000000000100000001
1111111110000000000000000000000100000001
100000C010000000000000000000000100000001
1001111110000000000000000000000100000001
100000C010000000000000000000000100000001
1000000000000000000000000000000100000001
1011111100000000000000000000000100000001
100000C100000000000000000000000100000001
1000000100000000000000000000E001000P0001
1000000000000000000000000000000100000001
1111111111111111111111111111111111111111
1000000000000000000000000000000000000001
111100C111111111111111111111111100000001
1000011100000000000000000000000100000001
100001C000000000000000000000000100000001
100001C000000000000000000000000100000001
100001C000000000000000000000000100000001
1000010000000000000000000000000100000001
1000011111111111111111111110000100000001
1000000000000000000000000000000100000001
100000C000000000000000000000000100000001
1111111110000000000000000000000100000001
100000C010000000000000000000000100000001
1001111110000000000000000000000100000001
100000C010000000000000000000000100000001
1000000000000000000000000000000100000001
1011111100000000000000000000000100000001
100000C100000000000000000000000100000001
1000000100000000000000000000E001000P0001
1000000000000000000000000000000100000001
1111111111111111111111111111111111111111
