11111111
10C010C1
10111001
1P000001
10010C01
1C0100E1
11111111

