111111111111111
111111111111111
111111111111111
11111PEC1111111
111111111111111
111111111111111
111111111111111
